1 1 1 1 1 1 1 1 1 1 1 1 1 1 1 1
1 0 0 0 0 0 0 0 0 0 4 4 4 4 2 2
1 0 0 0 0 0 0 0 0 0 4 4 4 2 2 2
1 0 0 0 0 0 0 0 0 0 4 4 2 2 2 2
1 0 0 0 0 0 0 0 0 0 4 4 2 2 2 2
1 0 0 0 0 0 0 0 0 0 4 4 2 2 2 2
1 0 0 0 0 0 0 0 0 0 4 4 2 2 2 2
1 0 0 0 0 0 0 0 0 0 4 4 2 2 2 2
1 0 0 0 0 0 0 0 0 0 4 4 2 2 2 2
1 0 0 0 0 0 0 0 0 0 4 4 4 2 2 2
1 0 0 0 0 0 0 0 0 0 4 4 4 4 2 2
1 1 1 1 1 1 1 1 1 1 1 1 1 1 1 1